1111111111111
100100000C001
1000000000001
1P00110000E01
1111111111111
