1111111111111111111111111111111111
100000000000000C00000C000000B00001
1010010100100000101001000000010101
1010010010101010001001000000010101
100000000C00C0000000000000B00000C1
100000000000000C00000C000000000001
1010010100100B00101001000000010101
1010010010101010001001000000010101
100000000C00C0000000000000000000C1
1E0000000000000C00000C000000000001
10100101001000001010010000B0010101
1010010010101010001001000000010101
1P0000000C00C00000000E00000000E0C1
1111111111111111111111111111111111
