1111111111111
1001B00000001
1B00000000001
1P0011111CE01
1111111111111
